1 0 0 1 1 1 1 1 1 1 1 1 1 1 1 1
1 0 0 0 0 0 0 0 0 0 0 0 0 0 0 1
1 0 0 0 0 0 0 0 0 0 0 0 0 0 0 1
1 0 0 0 0 0 0 0 0 0 0 0 0 0 0 1
1 0 0 0 0 2 2 2 2 0 0 0 0 0 0 1
1 0 0 0 0 2 2 2 2 0 0 0 0 0 0 1
1 0 0 0 0 2 2 2 2 6 0 0 0 0 0 1
1 0 0 0 0 2 2 2 2 2 6 0 0 0 0 1
1 0 0 0 0 0 0 0 7 2 2 6 0 0 0 1
1 0 0 0 0 0 0 0 0 7 2 2 6 0 0 1
1 0 0 0 0 0 0 0 0 0 7 2 2 6 0 1
1 1 1 1 1 1 1 1 1 1 1 7 2 2 6 1